0200000000000000000000000000000000000000
0111110000000000000000000000000000000000
0000010000000000000000000000000000000000
0000010000000000000000000000000000000000
0000010000000000000000000000000000000000
0000011111100000000000000000000000000000
0000000000100000000000000000000000000000
0000000000100000000000000000000000000000
0000000000100000000000000000000000000000
0000000000100000000000000000000000000000
0000000000100000000000000000000000000000
0000000000100000000000000000000000000000
0000000000100000000000000000000000000000
0000000000111111111000000000000000000000
0000000000000000001000000000000000000000
0000000000000000001000000000000000000000
0000000000000000001000000000000000000000
0000000000000000001000000000000000000000
0000000000000000001111100000000000000000
0000000000000000000000100000000000000000
0000000000000000000000100000000000000000
0000000000000000000000100000000000000000
0000000000000000000000100000000000000000
0000000000000000000000100000000000000000
0000000000000000000000111111111111000000
0000000000000000000000000000000001000000
0000000000000000000000000000000001000000
0000000000000000000000000000000001111111
0000000000000000000000000000000000000001
