2000000000000000000000000000000000000000
1000000000000000000000000000000000000000
1000000000000000000000000000000000000000
1111111111100000000000000000000000000000
0000000000100000000000000000000000000000
0000000000100000000000000000000000000000
0000000000100000000000000000000000000000
0000000000100000000000000000000000000000
0000000000111110000000000000000000000000
0000000000000010000000000000000000000000
0000000000000010000000000000000000000000
0000000000000010000000000000000000000000
0000000000000010000000000000000000000000
0000000000000010000000000000000000000000
0000000000000010000000000000000000000000
0000000000000010000000000000000000000000
0000000000000010000000000000000000000000
0000000000000010000000000000000000000000
0000000000000010000000000000000000000000
0000000000000010000000000000000000000000
0000000000000010000000000000000000000000
0000000000000010000000000000000000000000
0000000000000011111111111111111110000000
0000000000000000000000000000000010000000
0000000000000000000000000000000010000000
0000000000000000000000000000000010000000
0000000000000000000000000000000011111111
0000000000000000000000000000000000000000
0000000000000000000000000000000000000000
